dusk		adj.	黄昏
grief		n.	悲伤
goblet		n.	（尤指盛酒的，通常用玻璃或金属做的）无柄高脚杯
verge		n.	边；边缘；边沿
squash		vt.	把…压扁
squander	vt.	浪费，挥霍
apprentice	n.	学徒
intriguing	a.	吸引人的
intrigue	vt.	吸引，激起...的兴趣	n. 阴谋
urea		n.	尿素
continual	adj.	不断的, 频繁的
	continuous	adj.	连续的, 继续的, 连绵不断的
	continuum	n.	连续体；渐变体；逐渐演变的事物
scandal		n.	丑闻
	scandalous	a.	丑闻的
vehement	a.	（感情）强烈的；猛烈的
scold		vt.	责骂
alley		n.	小巷
booth		n.	货摊；电话亭
antenna		n.	天线；触角
errand		n.	使命
truncate	v.	截短，删节
connotation 	n.	内涵
charisma	n.	魅力，领导力
debt		n.	债务
shrewd		a.	精明的
	shrewdness	n.	精明
controvert	v.	争论
	controversy 	n.  	争议
	controversial   a.  	引起争议的
	uncontroversial	a.	不引起争议的	
	incontrovertible	a.	无可争议的

vengeance   	n.  	复仇
pharmacy    	n.  	药剂学；药店
	pharmacist  	n.  	药剂师
	pharmacology	n.	药理学
	pharmacologist	n.	药理学家
	pharmaceutical	a.	制药的	n. 药剂，药品	the pharmaceutical industry 制药业

contemptible    a.  	卑劣可鄙的   ->adv.  contemptibly
timid   	a.  	胆小的
daisy   	n.  	雏菊  ->pl.   daisies
emulate 	vt. 	模仿
contrive    	vt. 	发明；谋划
devise		vt.	发明，设计
stray   	v.  	迷路；跑题
panacea    	n.  	灵丹妙药/万能之计
meltdown    	n.  	（尤指金融方面的）灾难     financial/economic/market meltdown 金融／经济／市场崩溃
societal    	a.  	社会的	from society
tailor  	v.  	裁剪  n.  裁缝
parkland    	n.  	公园绿地(! not 停车场) 
acreage		n.  	面积(英亩数)
kudos		n.  	名声，声誉
distress    	n.  	痛苦		v.使痛苦
pugnacity	n.	好斗
	pugnacious	adj.	好斗的
	repugnant	adj.	令人反感的；不一致的
		repugnance	n.	厌恶；不一致，矛盾
	expunge		vt.	删除，抹去
	impugn		vt.	质疑
	oppugn		vt.	质疑

hatred		n.	仇恨，憎恨
disposition	n.	性格；倾向；
incongruous	adj.	不协调的，不一致的
hassle		vt.	烦扰；		n. 麻烦
physiognomy	n.	[FORMAL] 相貌，容貌
perverse	a.	有悖常理的；任性的

amorous		a.	表示性爱的，色情的
erotic		a.	性爱的，性欲的，色情的
genital		n.	生殖器 = genitalia [均为plural] (male: penis / female: vulva)
labium		n.	阴唇(folds on the outside of the female sex organs) usually plural: labia
	labia majora
	labia minora
vagina		n.	阴道
erectile	a.	（躯体组织或部位）能勃起的
ejaculate	v.	射精
	ejaculation	n.	射精
sperm		n.	精子；精液(=semen)；
	spermatozoon	n.	[生物学]精子（动物或植物的）	plural: spermatozoa
		spermatozoal	a.
	spermatozoid	n.	[生物学]植物精子
semen		n.	精液
	seminal		a.
gamete		n.	配子（指精子或卵子）
libido		n.	性欲	(plural. libidos)
repress		vt.	抑制，克制（感情）；（尤指用武力）镇压
	repression	n.	（尤指通过武力进行的）镇压，压制(subjugate)；（感情的）抑制，克制
mend		vt.	修理，修补；
transmute	vt.	使变形，使变质，把...变成...;
celibate	a.	禁欲的，没有性生活的	n.	禁欲者
	celibacy	n.	禁欲
impotent	a.	无能的，无力的；阳痿的
	impotence	n.	无能，无力；阳痿

tertiary	a.	[FORMAL]第三的；(primary secondary tertiary quaternary quinary senary septenary octonary nonary denary)
grump		n.	[INFORMAL]脾气坏的人
	grumpy		a.	脾气坏的，易怒的
marmalade	a.	果酱，橘子酱（涂在面包上吃，通常在早餐食用）
	marmalade cat	n.	(UK.)橘猫 = US. red tabby cat / orange tabby cat
eponym		n.	名祖，名字被用于命名其他事物的人，
	eponymous	a.	（人物与作品标题）同名的

furnishings	n.	家具
emissary	n.	使者
project		vt.	投掷，发射 	vi. 突出，伸出
	projecting	a.	突出的，伸出的
	projectile	n.	投掷物；抛射物；发射物（尤指子弹、炮弹等） a.	投射的
ballistic	a.	弹道的	ballistic missle 弹道导弹
vomit		v.	吐，呕吐 (vomit+up if intransitive)
lien		n.	（扣押某人财产直至其偿清债务的）留置令，扣押令
consortium	n.	财团；联合；
bedfellow	n.	伙伴，盟友
qua		prep.	[FORMAL]作为 = as
obscene		a.	淫秽的，下流的；令人震惊的
	obscenity	n.	淫秽；下流话，淫秽的言辞...骚话？

prig		n.	站在优越的角度对别人行为是否端庄得体做过分要求的人 = prude
	priggish	a.	[DISAPPROVING]一本正经的，死板的
prude		n.	过度关注行为是否端庄得体的人，过分拘谨的人
	prudery		n.
	prudish		a.

affect		vt.	影响；假装；
	affectation	n.	做作，装模作样

attentive	a.	（听或读）仔细的，认真的；关心的，体贴的

decor		n.	（房间内的）装饰布局，装饰风格 (elegant decor 雅致的装饰)
	decorate	vt.	装饰
		decorative	a.	装饰的
		decoration	n.	装饰（行为本身）；装饰品；
	decorum		n.	（行为）稳重，端庄
	decorous	adj.	端庄的，得体的
		indecorous	adj.

propriety	n.	（行为）得体，端庄

patriarch	n.	（男性）族长
	patriarchic = patriarchal
	patriarchal	a.	父权制的
	patriarchy	n.	父权制社会，男权社会

the Tropic of Cancer	n.	北回归线（Cancer n. 巨蟹宫）
the Tropic of Capricorn	n.	南回归线（Capricorn n. 摩羯宫)
aurora		n.	极光
the aurora borealis	n.	北极光	(also: the Northern Lights)
the aurora australis	n.	南极光	(also: the Southern Lights)

carcinogen	n.	致癌物
cinematography	n.	电影摄制艺术
stodgy		a.	无聊的，枯燥的
bulky		a.	笨重的，体积庞大的
	bulkiness	n.	笨重
forte		n.	长处，特长

cleft		n.	（岩石，地面的）裂口，裂缝

cleave 		v.	劈开；裂开；(US. ~ clove cloven)(UK. ~ cleaved cleaved)
	cleave to sth.	附着，紧贴；信守，忠于
		The ancient ivy cleaved to the ruined castle walls.  古老的常春藤紧紧攀附在破败的城堡墙上。
		People in the remote mountain villages still cleave to their old traditions.  边远山村的人们依然固守着古老的传统。

hew		vt.	砍，劈
	hew to sth	服从，遵守，忠于
		hew to tradition / hew to the line
# Hew is a strong, simple word of Anglo-Saxon descent. It can suggest actual ax-wielding, or it can be figurative: "If ... our ambition hews and shapes [our] new relations, their virtue escapes, as strawberries lose their flavor in garden-beds" (Ralph Waldo Emerson). It's easy to see how the figurative "shape" sense of "hew" developed from the literal hacking sense, but what does chopping have to do with adhering and conforming? That sense first appeared in the late 1800s in the phrase "hew to the line." The "hew line" is a line marked along the length of a log indicating where to chop in order to shape a beam. "Hewing to the line," literally, is cutting along the mark-adhering to it-until the side of the log is squared.

chop		v.	砍


aroma		n.	（通常指食物、饮料的）香味，香气，芳香
	aromatic	a.	有香味的

hypocrisy	n.	伪善
	hypocritical	a.	伪善的
	hypocrite	n.	伪善者，伪君子


flirt		vi.	调情，打情骂俏
	flirty		a.	轻浮的，轻佻的
	flirtation	n.	调情，打情骂俏
	flirtatious	a.	打情骂俏的，轻佻的

diocese		n.	主教辖区 an area controlled by a bishop
	diosesan	a.	主教辖区的

nettle		vt.
	nettlesome	a.	烦人的，讨厌的

vituperate	v.	辱骂	~= berate	[FORMAL]
	vituperation	n.	辱骂
	vituperative	a.	辱骂的

indurate	vt.	使...变硬	adj. 铁石心肠的
obdurate	a.	顽固的，倔强的
sedate		a.	平静的(=unruffled)	vt. 给...服镇定剂
	-ly		adv.
	-ness		n.	(adj -> noun)
	-tion		n.	(v -> noun)
	sedative	a.	使人平静的	n.	镇静剂

treason		n.	叛国（罪）
tenet		n.	基本原则，宗旨 [FORMAL]one of the principles on which a belief or theory is based

sense
	sensible	a.	明智的；意识到的 be sensible of = be cognizant of;（形容衣物）实用的（而非时髦花哨的）
		insensible	a.	无动于衷的(be ~ of/to)；失去知觉的；
			insensibility	n.	冷漠，不在乎；失去知觉的状态；
		sensibility	n.	鉴赏力，感受力；感情；
	sensitive	a.	（人）敏感的，（机器）灵敏的；（话题）敏感的；善解人意的；
		sensitivity	n.	善解人意；敏感性，（机器的）灵敏度
		insensitive	a.
	sensory		a.	感官的，感觉上的
		extrasensory	a.	超感的
		multisensory	n.	多感官并用的
	sensual		a.	感官的(=sensory)；肉欲的，愉悦肉体的
	sensuous	a.	感官的(=sensory)；引起美感的；
	senseless	a.	无意义的；失去意识的；
	nonsense	n.	胡闹，愚蠢，一派胡言
	sensor		n.	传感器
		sensorial = sensory	a.
	sensate		a.	感知的（强调通过感觉理解）（不常用 Bottom 40%）
		insensate	a.	无感觉的；无动于衷的，冷漠的；
		sensation	n.	感觉；轰动性事件；
			sensational	a.	极好的；（新闻报道）耸人听闻的
				sensationalize	v.
	sentiment	n.	观点；情绪；（愚蠢或不合适的）伤感，温情；
		sentimental	a.	感情（上）的；多愁善感的，过度感伤的[DISAPPROVING]；
			sentimentalism	n.	多愁善感 being sentimental
				sentimentality = sentimentalism
				sentimentalist	n.	多愁善感者
			sentimentalize	v.	感情化，强调失去了客观性	Her book sentimentalizes parenthood and completely ignores the disadvantages of it.
			unsentimental	a.	冷漠的，无感情的	not marked or governed by feeling, sensibility, or emotional idealism
	sentient	a.	有知觉的，有感知力的
		insentient	a.	无知觉的，无生命的
		# **dissentient	a. n.	不同意的 expressing `dissent`
		sentience
		presentient

ethnic	a.	种族的；民族特色的；
	ethnical = ethnic
	ethinicity	n.	种族
	ethnology	n.	人种学

Caucasian	n.	高加索人
stratum		n.	地层；阶级 [pl. strata]
	stratify	v.	使...分层
	stratigraphy	n.	地层学
	substratum	n.	基础，根基

circle
	circulate	v.	（使）循环，（使）流通
		circulation	n.	循环，流通
	encircle	vt.	围绕
	circular	a.	圆形的，环形的；	n. 传单
		circularize	v.

hypocrisy	n.	虚伪，伪善
	hypocrite	n.	伪善者（满嘴仁义道德，实际虚伪可耻的人）
	hypocritical	a.	伪善的

vitriol		n.	刻薄（原指硫酸盐 dated）
	vitrolic	a.	刻薄的（硫酸的，硫酸盐的 dated）

metallurgy	n.	冶金学
raven		n.	大乌鸦	v. 掠夺
	ravage		v.	（严重地）破坏，毁坏
	ravish		vt.	掠夺；使...陶醉；强奸
		ravishment	n.
		ravishing	a.	极其美丽的

cognitive	a.	认知的
	cognizant	a.	意识到的
		incognizant	a.	未意识到的
	cognition	n.	认知
		precognition	n.	预知

mule		n.	骡子
	mulish		a.	（骡子般）顽固的	
quaff		v.	痛饮，大口喝

permeate	v.	[具象的物质，但可指抽象事物]渗透，弥漫
	permeation	n.
	permeant	adj.	渗透的
	permeable	a.	可渗透的	Certain types of sandstone are permeable to water.  某些类型的沙岩可渗水。
		permeability	n.	渗透性		Chalk has a high permeability (= liquids easily pass through it).  粉笔的渗透性很强。

pervade		v.	[抽象](信息，情绪的)弥漫，渗透	to spread or diffuse through
	pervious	a.	可渗透的
	pervasive	a.	弥漫的，遍布的，*普遍的*
	pervasion	n.

percolate   	vi.  	（液体）渗透；（信息）扩散，弥漫；
	percolation	n.

filter		vi.	渗入，渗透	vt.	过滤	News filtered down to us during the day. 白天的时候消息慢慢传到了我们这里。

infiltrate	v.	（使）（液体）渗透；（特工）渗入（敌对组织、危险区域等）；

sour vinegary	a.	酸味的
	vinegar		n.	醋
bitter		a.	苦味的
spicy pungent piquant fiery	a.	辛辣的
	garlic		n.	大蒜
	ginger		n.	姜
	pepper		n.	胡椒
	chili pepper	n.	红辣椒

honor		n.	荣誉
	honorable	a.	光荣的，可敬的
	honorary	a.	（尤指学位）荣誉的，名誉的	honorary doctorate
	dishonor	vt.	使丢脸，使蒙羞	n. 耻辱
	honorific	a.	表示尊敬的	an honorific title 尊称
resultant = resulting = consequent	a.	作为结果的[resultant最为正式]
hunch		n.	预感，直觉
complexion	n.	（天然的）面色；总体特征，性质
merchant	n.
	mercantile	a.	贸易的，商业的
		mercantilism	n.	重商主义（认为一国的国力基于通过贸易的顺差，主张国家干预经济，最先由亚当斯密提出和反对）
	merchandise	n.	商品[formal]	v. 促销
		merchandising	n.	推销，促销
		merchandiser	n.
	mercenary	a.	唯利是图的	n. 雇佣兵

stale		a.	（通常指因久放）不新鲜的
pass
	passage		n.
	surpass		vt	超越，胜过
		unsurpassed	a.	未被超越的，不可超越的
	trespass	vi.	侵入
		trespasser	n.	侵入者
	bypass		vt.	绕过；忽视

urban		a.	城市的
	urbanite	n.	都市人，城市居民
	suburban	a.	市郊的，郊区的
		suburbia	n.	郊区
		suburbanite	n.	郊区居民
	urbane		a.	（尤指男子）从容自信的，温文尔雅的
		urbanity	n.

luxury		n.
	luxurious	a.	奢侈的；舒服的； The cat gave a long, luxurious stretch.  猫舒舒服服地伸了一个长长的懒腰。	(=sumptuous)
	luxuriate	v.	（尤指物质方面）享受，享用
	luxuriant	a.	茂盛的；浓密的
		luxuriance	n.
		luxuriantly	adv.

retaliate	v.	报复
	retaliatory	a.	报复性的
	retaliation	n.	报复

über-	uu-ber		prefix.	（用于名词前）极度的，超级的，极好的，极成功的	über-billionaire 超级富翁
consulate	n.	领事馆

speculate	v.	推测；投机，做投机买卖
	speculation	n.
	speculative	a.
	speculator	n.	投机者

spectate	vi.	观看
	spectator	n.	（尤指体育赛事的）观众
	spectacle	n.	场景；眼镜
		spectacular	a.	壮观的
			spectacularly	adv.	壮观的；极度的(=extremely)

specter		n.	鬼魂（幽鬼） US. = UK. spectre

jewel		n.	宝石	v. 用宝石装饰，镶以宝石
	jeweled		a.	宝石装饰的 US = UK jewelled
	jewelry		n.	（总称）珠宝，首饰 US = UK jewellery
	jeweler		n.	宝石匠 US = UK jeweller

Jew		n.	犹太人
	Jewish		a.	犹太人的
		Jewishness	n.
	Jewry		n.	（总称）犹太人(=all the Jews)
	Judaism		n.	犹太教


petrol		n.	汽油（透明）	UK = US **Gasoline**
	petroleum	n.	石油（黄黑色）
	petrology	n.	岩石学

generous	a.	慷慨的(antonym: un~)
	generosity	n.	慷慨

prey		n.	被捕食者
	predator	n.	捕食者
		predatory	a.	捕食猎物为生的；掠夺的	
		predaceous = predatory

suspend		v.	悬挂；暂停
	suspension	n.	悬挂；暂停；悬浮液
		suspensory	a.	悬挂的
	suspense	n.	悬念
		suspenseful	a.	有悬念的
	suspensive	a.	暂停的；有悬念的；(bottom 20%)

suspect		vt.	怀疑	n. 嫌疑犯	a.可疑的
	suspicion	n.	怀疑
	suspicious	n.	（引起）怀疑的	Her behaviour was very suspicious.  她的举止非常可疑。
		-ly		adv.
		-ness		n.	疑心

solar plexus	n.	心口，心窝 a punch in the solar plexus 打在心口上的一拳

conceive	v.	构思；怀孕；
	conception	n.
	conceivalbe	a.	能想到的 Books on every conceivable subject 能想到的所有学科的书
		-ly	adv.
		in-	a.

concept		n.
	conceptual	a.
		conceptualize	v.
		conceptualist	n.
		conceptualism	n.

# suffuse	强调充满
# diffuse	强调扩散这一动作本身
# n. -fusion	a. -fusive
fuse		v.	（使）熔化，熔合	n. 保险丝
	fusible		a.	易熔的
	fusion		n.	熔合
	suffuse		vt.	弥漫于，*充满*，遍布	[LITERARY]
		suffusion	n.
		suffusive	a.
	perfuse		vt.	弥漫，布满(=suffuse)；扩散(=diffuse)；
		perfusion	n.
		perfusive	a.
	circumfuse	vt.	=surround	环绕，包围
		circumfusion	n.
	diffuse		v.	（气体、液体）扩散；（信息，知识）扩散（传播）	adj. 分散的
	effuse		vt.	to pour out (a liquid)	vi. to flow out (=emanate) 散发		vi. to make a great or excessive display of enthusiasm: they effused about his accomplishments
	infuse		v.	注入（情感）	to fuse someone/something with an emotion or quality
	profuse		a.	大量的(=boutiful)	a profuse harvest 大丰收	*CUSTOMARY COMBINATION*: If you offer profuse apologies or thanks, you apologize or thank someone a lot.
	transfuse	vt.	输送（液体，血液）；传输(=transmit)；渗透，穿透 sunlight transfuses the bay(月桂树)；
		transfusion	n.
	defuse		vt.	平息，缓和
	confuse
	refuse


stupefy		v.	使昏昏沉沉；使震惊
	stupefaction	n.
	stupor		n.	昏迷，神志不清

fane		n.	寺庙
	profane		v.	亵渎
		profanation	n.

precipice	n.	悬崖
	precipitous	a.	陡峭的；变化急剧的
	precipitate	v.	促成	a. 仓促的
		precipitation	n.	降水；冲动；沉淀物

cerebrum	n.	大脑
	cerebral	a.	脑的
	cerebrate	v.	用脑思考
		cerebration	n.

coinage		n.	造币；新造的词

vouch		vi.	证实；担保 ~ for
	avouch		vt.	证实；担保
	voucher		n.	证人 -> 代金券

pest		n.
	pesky		a.	讨厌的，烦人的
	pesticide	n.
	pestilent	a.	致命的；危害社会的
		pestilential	a.	=pestilent
		pestilence	n.	瘟疫；毒害之物	I'll pour this pestilence into his ear - Shakespeare

pernicious	a.	(极其)有害的
detrimental 	a.	有害的
nocuous		a.	[rare]
	innocuous	a.	无害的
poisonous	a.

announce	vt.	宣布，声明
renounce	vt.	宣布放弃
denounce	vt.	谴责；检举告发；

licit		a.	合法的
	illicit		a.	不合法的

timid		a.	胆怯的，害羞的
	timorous = timid	[LITERARY]
	intimidate	vt.	威胁，恐吓
		intimidatory	a.
			intimidation	n.

edify		vt.	启迪
	edification	n.
	edifice		n.	大厦；体系架构；

inspect		vt.	检查，视察
	inspection	n.

inquire		v.	问，询问	(UK. sometime enquire)
	inquiry		n.
	inquiring	a.	刨根问底的
	inquirer	n.	询问者
	inquisitor	n.	[贬]讯问者，问题过多的询问者
		inquisitive	a.	好奇的，好问
			-ly		adv.
			-ness		n.	好奇
		inquisition	n.	[贬]盘问(asking unfriendly)；审讯
			the Inquisition	n.	（旧时天主教的）宗教法庭

gratify		v.	使高兴，使满意
	-ing		a.	令人～的
	gratification	n.	愉悦，满足
	grateful	a.	感激的
		un-		a.	不感激的->忘恩负义的
	gratitude	n.	感激的心情
		in-		n.	不感激->忘恩负义
	gratuity	n.	小费，赏钱
		gratuitous	a.	（工作）无报酬的；（人）不求报酬的；（商品）免费的；bad and unnecessary
	ingratiate	v.	为...赢得好感(usual: A ingratiate A-self with B = A讨好B)
		ingratiating	a.	[贬]迎合的，奉承的
		ingratiation	n.
		ingratiatory = ingratiating

specifics	n.	细节 = detail
revelry		n.	（尤指吵闹地）狂欢，作乐
obnoxious	a.	令人反感的，粗鲁无礼的
objectionable	a.	令人反感的

convivial	a.	友好的；欢乐的，愉悦的 a convivial atmosphere/host 欢乐的气氛／热情的主人
recompense	n.	支付，酬谢，报答；补偿
requite		vt.	回报（报答或报仇）
	requital	n.
	unrequited	a.	无回报的；（爱情）单方面的，得不到回报的，单相思的；
compensatoin	n.	补偿

unearned	a.	不劳而获的
grain		n.	颗粒
	granule		n.	颗粒		coffee granules 咖啡粒
		granular	a.	颗粒状的
			granularity	n.	粒度

strapping	a.	(人)魁梧的

indemnify	vt.	保障，担保
	indemnity	n.	保障，担保
	indemnification = indemnity

sparing		a.	节俭的
liquor		n.	烈酒		intoxicating liquor

temper		n.	脾气，性情	vt. 使缓和	I learned to temper my criticism.  我学会了批评别人时语气要缓和些。
	temperate	a.	气候温和的；（行为）温和的，适度的 calm and controlled
		in-		a.
		temperance	n.	自我克制，节制（如戒酒、节食等）
		temperament	n.	性情，气质
			temperamental	a.	喜怒无常的；性情的；（机器）性能不稳定的
		temperature	n.	温度

# tempor-: time(latin)
temporal	a.	时间的；尘世的，物质的（与spiritual相对）
	temporary	a.	临时的
		contemporary	a.	当代的；同时代的；	n. 同时代的人，同辈
	temporize	vi.	拖延(=procrastinate);妥协(=compromise)

earthly		adj.	尘世的，世俗的(literary: happening in or relating to this world and this physical life, not in heaven or relating to a spiritual life); （用于疑问句或否定句中）可能的，能想到的 What earthly reason can she have for being so horrible to you?  她对你这么不友好，到底什么原因？

secular		a.	世俗的，非宗教的(not having any connection with religion)

contrast	n.	反差，对比	vt. 对比	vi. 形成对照	The styles of the two film makers contrast quite dramatically.  两位电影导演风格迥异。
contrary	n.	相反，对立面	a. 相反的，对立的	on the contrary = to the contrary 正相反
converse	n.	相反，对立面	a. 相反的，对立的	vi.+with 与某人交谈	Conversely...	相反...		the converse 相反的事物

rigor		n.	（脾气、观点的）死板
	rigorous	a.	（法律）严厉的；（研究）严谨的；
		-ness		n.
	rigid		a.	僵硬的；刚硬的，不能弯曲的；死板的；严格的
		non-		a.
		-ness		n.
		rigidity	n.	死板；（金属）刚性；

fable		n.	寓言；神话；谎言
	-ed		a.	传奇式的；虚构的；
	fabulous	a.	极好的；虚构的；
		-ly		adv.

cite		vt.	引用
	citation	n.	引用
	incite		vt.	煽动
		incitement	n.
	excite		vt.	使...激动；**激起，引起(formal)**
		-ed
		-ing
		excitable	a.	易兴奋的；易激动的；
		excitant	a.	刺激性的；兴奋剂；
		excitement	n.
		excitation	n.

	recite		v.	背诵，朗诵；列举(enumerate)；
		recitative	a.	背诵的	n. 背诵，朗诵(=recitation)
		recitation	n.	背诵，朗诵；列举(enumerating)；
		recital		n.	独奏会

meteor		n.	流星（穿过地球大气的流星体） = shooting star
	meteoric	a.	流星的；如流星般（耀眼/快速/短暂）的；
	meteoroid	n.	流星体（还未进入地球大气）
	meteorite	n.	陨石（已经落地的）
	meteorology	n.	气象学
		-ic
		-ical
		-ist

toxic		a.	有毒的；（人）中毒的；
	toxicant	n.	有毒物
	toxicity	n.	毒性
	toxin		n.	毒素
	toxicology	n.	毒理学
		-gical		a.
		-gist		n.
	intoxicate	vt.	给...下毒；使醉倒；使沉醉；
		intoxicant	n.	致醉物；麻醉品		a. 醉人的 = intoxicating
		intoxication	n.
	antitoxic	a.	抗毒的
		antitoxin	n.	抗毒素

antidote	n.	解毒剂

pure		a.
	purly		adv.
	impure	a.
		impurity	n.
	purist		n.	正统主义者
	purity		n.	纯净，纯粹
	purify		v.
		purification	n.
	purge		v.	肃清；净化（邪恶）；通便；	n. 政治肃清
		purgation	n.
		purgatory	a.	（天主教教义中的）炼狱，涤罪所；[humorous]炼狱般的经历
		purgative	a.	泻药(=laxative)

sinus		n.	鼻窦???wtf
	sinuous		a.	[literary]弯曲的，蜿蜒的
	insinuate	vt.	1. to introduce (something, such as an idea) gradually or in a subtle, indirect, or covert way （渗入？） 2. 影射，含沙射影地说(something unpleasant);
		-ing		a.
		insinuation	n.

ordinate
	subordinate	n.	下属，下级 adj. 下级的；次要的 vt. 征服（使从属于，使处于次要地位）
	superordinate	n.	上级，上司(=superior)	a.
	coordinate	vt.	协调，使配合	vi. 相配(A ~ with B)	n. 坐标

respire		vi.	呼吸
	respiratory	adj.	呼吸的
	respiration	n.	呼吸
		artificial respiration
		photorespiration	n.	光呼吸（作用）

semble		= It seems	多用于法律领域	e.g. Semble that ...
	semblance	n.	相似，近似
	resemble	vt.	像
	assemble	v.	组装；集合	(拆卸dismantle);(解散dismiss)
	dissemble	v.	掩盖，掩饰
	ensemble	n.	全体，整体；乐团，剧团；

proselyte	n.	改变信仰者	v. =proselytize
	proselytize	v.	使改变信仰
		-er = -ist	n.	劝说他人改变信仰者
			proselytistic	a.
		proselytization	n.
	proselytism	n.	改变信仰

escort		vt.	护送
moralize	vi.	说教[贬]

dominant
	predominant
		-ly

laconic		a.	简洁的
	laconism	n.	简洁(brevity or terseness of expression or style)；一条简洁的表述(a laconic expression)
	laconicism = laconism

delinquent	a.	拖欠的[FORMAL]；（青少年）不良的，违法的	n. 不良少年
due		a.	预计的；
	overdue		a.	过期的，延误的

imminent	a.	临近的，即将发生的，迫在眉睫的
inferior	a.	差的；下等（阶级）的	be inferior to 比...次
	antonym: superior

ignis fatuus	n.	鬼火，磷火

vigil		n.	守夜		Vigil Knight 守夜骑士
	vigilant	a.	警惕的，警觉的
		vigilance	n.	警惕，警觉
	vigilante	n.	（尤指认为警方无法维持治安而自发组织起来的）治安会会员，治安维持者

vacillate	vi.	摇摆不定；犹豫不决；(to waver in mind, will, or feeling : hesitate in choice of opinions or courses)	*可以指物理上的摇摆*
	vacillant	a. = vacillating
	vacillation	n.

penal		a.	刑罚的，刑事的
	penalty		n.	惩罚
	penalize	vt.	惩罚

penance		n.	忏悔	v. 迫使...忏悔
repent		vi.	后悔，忏悔
	repentant	a.	悔悟的
		unrepentant	a.	不思悔改的
		repentance	n.	后悔，忏悔

penitent	a.	（感到）悔悟的，悔改的
	impenitent	a.	不知悔改的
	penitence	n.
	penitency = penitence
	penitential	a.	（和）悔悟（有关）的
	penitentiary	n.	监狱

tantalize	vt.	吊胃口，使...干着急
	-zation		n.

Hades		n.	冥界；哈迪斯；
Styx		n.	冥河
	Stygian		a.	地狱的，冥河的

venerate	vt.	尊敬 [FORMAL]
	venerable	adj.	德高望重的（强调得到尊重是因为年龄或社会地位）
		Venerable	n.	（天主教）尊者；（佛教）法师 [均为尊称]
	veneration	n.

vile		a.	邪恶的；可耻的；极令人厌恶的
	revile		vt.	谩骂，辱骂[FORMAL]
	vilify		vt.	诋毁，诬蔑
		vilification	n.
turpitude	n.	邪恶，堕落
iniquity	n.	邪恶，不公正
abusive		a.	辱骂的		an abusive letter/phone call 辱骂信／电话 He was apparently abusive to the flight attendants.  显然他对航班乘务员说了些不干不净的话。

withhold	vt.	拒绝给予
rail		vi.	抱怨，谴责(usually rail at/against)
	raillery	n.	（善意的）戏谑，玩笑，揶揄

lu-, lumin- = light(Latin)
	luster		n.	光泽，光辉 = UK. lustre
		lustrous	a.	有光泽的
		lackluster	a.	黯淡无光的

	lucent		a.	透明的
		lucency		n.	透明
		translucent	a.	透明的；半透明的；

	lucid		a.	清晰明了的，易懂的
		lucidity	n.
		pellucid	a.	清澈透明的，易懂的；

	elucidate	v.	阐明，解释

	luminous	a.	发光的
		luminary	n.	知名人士
		illuminate	vt.	照亮；阐明，解释
			illumination	n.
			illuminati	n.	智者，博学者

	illustrate	v.	举例说明；给...插图；
		illustrator	n.	插画家
		illustration	n.
		illustrious	a.	著名的，卓越的
		illustrative	a.	起说明作用的，作为例证的


prelude		n.	序幕，先声	The changes are seen as a prelude to wide-ranging reforms.  这些变化被视为大范围改革的序幕。

olympiad = 4 years
lustrum = 5 years
decade = 10 years
indiction = 15 years
century = 100 years
millennium = 1000 years

inhere		vi.	固有，原本就有	Does selfishness inhere in each of us?
	inherent	a.	内在的，固有的
		inherence	n.	内在，固有
		inherency = inherence

adhere		vi.	粘；遵守，忠于；	(~ to)
	adhesive	a.	有粘性的；	n. 粘合剂；[没有抽象的意思，这个词指且仅指物理性质]
	adherent	a.	有粘性的；遵守的；	n.	信徒，追随者
		adherence	n.	粘性，附着性；遵守，忠诚	adherence of paint to wood 油漆和木料之间的附着性	He was noted for his strict adherence to the rules.  他因为严守规则而闻名。	nations adherent to the treaty 遵守条款的国家

cohere		vi.	（论据或理论）连贯，有条理(all the stages of an argument or theory fit together to form a reasonable whole)；合为一体；The various elements of the novel fail to cohere.  这部小说的各部分之间无法连贯起来。
	coherent	a.	一致的，连贯的（强调逻辑上能成为一个整体的）；（人）说话清晰有条理的；（光）相干的
		coherence	n.	连贯性
		coherency = coherence
	cohesive	a.	连贯的，一致的；有凝聚力的；
	cohesion	n.	凝聚力，团结

viscid		a.	粘性的(=adhesive, sticky)；黏稠的(viscous)；
	viscous		a.	黏稠的
		viscosity	a.	黏稠度

consistency	a.	一致性；**黏稠度(=viscosity)**(但是consistent没有`粘稠的`的意思)	Boil the juice to the consistency of a thick syrup.

maple		n.	枫树
syrup		n.	糖浆
	maple syrup	n.	枫糖浆

heinous		a.	罪大恶极的
	heinousness	n.
hideous		a.	极丑陋的；（罪行）可怕的

slander		vt./n.	诋毁，诽谤
slender		a.	苗条的，纤细的

plagiary = plagiarism		-[archaic]剽窃者 = plagiarizer
	plagiarize	v.	剽窃
	plagiarism	n.	剽窃


lightly		adv.	随便地，不严肃地(=casually?)

the Orient	东方国家
the Occident	欧美国家

sublime		vt.	使升华（物质直接由solid转化为vapor）	a.	极好的
	the sublime	n.	极好之物

dread		n.	恐惧	vt. 感到恐惧
	dread to think		不愿想；不敢想 I dread to think what would happen if he was left to cope on his own.  我不敢想象，如果让他自己去应付会怎么样。

civil
resilient	a.	有弹性的，能复原的

venal		a.	唯利是图的，贪污腐败的
	venality	n.	贪婪，腐败

sophism		n.	诡辩
surge		n.	剧增；涌现；（情感的）涌起，翻涌；	vi.	剧增；涌动；（情感的）涌起，翻涌；
	surgence	n.
	insurgent	n.	叛乱者，反叛者	[FORMAL]	a. 叛乱的
		insurgency	n.	叛乱（的状态）；叛乱（这一行为本身）(=insurgence)；
			counterinsurgency	n.	（政府的）反暴乱的军事行动
		insurgence	n.	叛乱（这一行为本身）(=insurrection)
	resurge		vi.	复活，复兴
		resurgent	a.	复活的，复兴的
		resurgence	n.	复活，复兴

hysteria	n.	歇斯底里
dismal		a.	阴沉的，凄凉的

impale		vt.	刺穿，刺死
rescind		vt.	废除，撤销

ferment		v.	（使）发酵；（使）事态发酵->煽动=foment	n. 骚动，动乱
	fermentable	a.
		fermentability	n.
	fermentation	n.
yeast		n.	酵母；导火索（煽动群情之事物）	were all seething with the yeast of revolt — J. F. Dobie
seethe		vi	（大量人或物在狭小的空间内）涌动，密集，云集
dough		n.	面团
	sourdough	n.	酵头（包含酵母的面团）
leaven		n.	酵母	v. 发酵；使生动有趣

subside		vi.	缓和，平息；下降，下沉
	subsidence	n.
	subsidy		n.	补助金，补贴
		subsidize	vt.	补助，资助
		subsidiary	a.	辅助的，次要的；子公司，附属公司
tort
	distort		vt.	扭曲（事实）
	contort		v.	（物理）扭曲
	retort		vt./n.	（愤怒或风趣地）反驳，回嘴
	extort		vt.	敲诈，勒索

tortuous	a.	曲折的；拐弯抹角的；

torpor		n.	不活跃，萎靡，无精打采
	torpid		a.	不活泼的，萎靡的，无精打采的
		torpidity	n.	= torpor

torture		vt./n.	折磨，拷问	bottom 50%
torment		vt./n.	折磨，拷问	top 40%

torpedo		n.	鱼雷；	v.	用鱼雷破坏； -> 破坏，毁坏[INFORMAL]

torrid		a.	炙热的；热情的；	1. hot, scorching 2.ardent
	torridly	adv.
	torridity	n.
	torridness	n.

turgid		a.	（写作）枯燥而浮夸的
turbid		a.	浑浊的

forbear		vi.	克制，忍耐
	forbearance	n.

forebear	n.	祖先

scarcely	adv.	几乎不 = barely = hardly

slumber		vi. n.	睡眠	[LITERARY]
drowsy		adj.	睡意朦胧的
	drowsiness	n.	睡意	
sleepy		a.	困的，想睡的；（场所、地点）静寂的，冷清的(a sleepy place is quiet and does not have much activity or excitement)；
	sleepyhead	n.	瞌睡虫（贪睡者）（尤指儿童）[INFORMAL]

beauty sleep	n.	美容觉(the sleep that you need in order to feel and look healthy and attractive)

somnolent	a.	想睡的，昏昏欲睡的(=sleepy)
	somnolence	n.	瞌睡，昏昏欲睡
	somnambulism	n.	梦游 [SPECIALIZED]
		somnambulist	n.	梦游者

drowsy		a.	想睡的，睡意朦胧的，昏昏欲睡的

sopor		n.	[医]昏睡	profound or lethargic sleep
	soporific	a.	催眠的	causing sleep or make a person want to sleep
		soporifically	adv.
	soporiferous = soporific

mesmeric	a.	催眠术的；令人着迷的
	mesmerize	vt.	催眠；迷住；	= hypnotize
	mesmerism	n.	催眠术		= hypnotism
		mesmerist	n.

hypnotic	a.	催眠的；令人着迷的；
	hypnosis	n.	催眠状态
	hypnotize	v.	催眠；使...着迷于(passive)	I was hypnotized by his steely grey eyes.  我被他那双神情坚毅的灰色眼睛迷住了。
	hypnotism	n.
		hypnotist	n.

magnetism	n.	磁力；**吸引力，魅力**
trance		n.	催眠状态，恍惚，出神

statute		n.	法令（强调已批准，且已成文的法律）
	statutory	a.	法定的
ordinance	n.	法令，法规[FORMAL]


scrupulous	a.	acting in strict regard for what is considered right or proper;punctiliously exact
punctilio	n.	品行的细节；对形式、礼节的遵守；
	punctilious	a.	一丝不苟的；循规蹈矩的；


ruff		n.	褶皱衣领
	ruffle		vt.	弄乱，弄皱；使生气;
		unruffled	a.	平静的，泰然自若的

disown		vt.	声明与...断绝关系
clunky		a.	笨重的
lethal		a.	致死的
	sublethal	a.	尚不致死的...我背这个干嘛》》？》？《？》《？》	
innocuous	a.	无害的

corporate	a.	公司的；集体的；
	incorporate	v.	吸收，包含
	corporation	n.	大公司
	corporatism	n.	社团主义

build		n.	身材

-turb
	perturb		v.	打扰，使不安 [FORMAL]
		imperturbable	a.	沉着的，泰然自若的
	disturb		v.	打扰，使不安

shun		vt.	躲避；避免；

fervor		n.	热情，热心；炎热；	intensity of feeling or expression, a strong sensation
	fervid = fervent (bottom 40%)
	fervent		a.	热情的；炎热的；(top 20%)
		fervency = fervor

resolute	a.	坚决的，坚定的
	resoluteness	n. 决心，坚决(=resolution)

caliber		n.	口径；才能；水平； UK calibre
	calibrate	vt.	调准，使标准化
		calibration	n.

shrivel		v.	（使）枯萎；萎缩；(US -l- UK -ll-)	Profits are shrivelling as the recession gets worse.  随着经济衰退的加剧，利润不断萎缩。
parody		vt. n.	滑稽模仿（作品）

dogma		n.	（宗教的）教条，教义（可略带贬义，强调死板、不容置疑地相信）
	dogmatic	a.	教条的；自以为是的，武断的
		dogmatism	n.	武断，教条

undergrowth	n.	树下灌木（bush是普通的灌木？）
immanent	a.	内在的
	immanence	n.

percipient	a.	有洞察力的，洞察力强的 [FORMAL]
impudent	a.	（尤指对年长者或上级）放肆的，无礼的
plunder		v.	掠夺，窃取
refract		vt.	使折射		The glass prism refracted the white light into the colours of the rainbow.  玻璃棱镜将白色光折射成彩虹的七色光。
stain		n.	污迹	v. 沾污
enthrall	v.	吸引，迷住	The baseball game completely enthralled the crowd.  棒球赛使得观众们完全着了迷。
lapse		n.	失误，过失
	elapse		vi.	（时间）流逝
	collapse	vi.	倒塌，倒下
		colapsible	a.	可折叠的
	prolapse	n.	（器官的）脱垂
	relapse		v. n.	旧态复萌；旧病复发；

stage-manage		vt.	精心安排	stage-managed = carefully choreographed
management		n.	资方，管理层
per se			adv.		[FORMAL] by or of itself 自身，本身 Research shows that it is not divorce per se that harms children, but the continuing conflict between parents.  研究表明，对孩子造成伤害的不是离婚本身，而是父母间持续的矛盾。

incinerate		v.	焚烧
	inceneration		n.

sporadic		a.	偶尔的；零星的；（强调不稳定，无规律） = occasional
	sporadically		adv.
	sporadicity		n.

affix			vt.	附上，粘上	She affixed a stamp to the envelope.
她把一张邮票贴在信封上。	n. [linguistics]词缀 a group of letters added to the beginning or end of a word to make a new word

austere		a.	艰苦的；朴素的；
	austerity	n.	艰苦；朴素；

propel		vt.	推动(尤指物理上的)
	propulsion	n.
impel		vt.	驱使(im强调内在的动力)
compel		vt.	强迫；激起，引发[FORMAL]；
	compelling	a.
repel		vt.	驱逐；使...厌恶
	repellent	a.	令人厌恶的；	n.驱虫剂；	mosquito repellent

aisle		n.	（客机、电影院或教堂座席间的）走廊，过道，（商店货架间的）通道
	go/walk down the aisle		[informal] to get married 结婚

treachery	n.	背叛[FORMAL]
	treacherous	a.	背信弃义的；（因环境恶劣）极端危险的；


# -duce和-duct没有任何直接联系，但是两者的名词形式都是-duction，所以同一个单词出现在了不同词根树上，词意叠加。
adduce		vt.	举出（理由、证据）[FORMAL]	None of the evidence adduced in court was conclusive.  在法庭上引证的证据都不确凿。
	adduction	n.
conduce		vi.	促进，导致(often desirable result)[FORMAL]	the belief that technological progress conduces to human happiness	“技术进步会促进人类幸福”这一信念
	conducing	很遗憾名词不是conduction，conduction完全没有“促进，导致”的意思。
deduce		vt.	推断，推理		refer to: infer
	deducible	a.	able to be deduced 可以推断的（能由推断得知的？）
	deduction	n.	推断
induce		vt.	导致；劝说；
	induction	n.	引发，诱导；[specialized]电磁感应
	inducement	n.	引诱（物），诱惑
reduce		v.	减少；化简，归纳；[数]约分；
	reduction	n.	减少；[数]约分；
		reductionism	n.	简化论，简化主义
	reductive	a.	精简的，
		reductivism = reductionism
	reducible	a.	可减少的；可化简的；
		irreducible	a.

seduce		vt.	诱惑；吸引；(sex)勾引；
	seducer		n.	勾引者
	seduction	n.	诱惑，吸引力
	seductive	a.	诱人的，有诱惑力的
		seductively	adv.
		seductiveness	n.
traduce		vt.	强烈批评
	traduction	n.

# -duct
abduct		vt.	绑架，劫持
	abduction	n.	绑架
conduct		vt.	进行；指挥；传导；	n. 行为品行
	conduction	n.	传导
	conductor	n.	导体		MIND CONDUCTOR!
deduct		vt.	减去，扣除(=subtract)；推断，推理(=duduce, infer)；
	deduction	n.	扣除；所得税（得到收入之前被扣除的部分）；
induct		vt.	使...就职	Li Xiannian was inducted into the Politburo in 1956.  李先念于1956年进入政治局。
	induction	n.	就职，入职
viaduct		n.	高架桥


gross		a.	（尤指违法行为）严重的，恶劣的，极端的
	grossly		adv.	非常，极端

incept		v.	开始；就职；获得学位；
	inception	n.	开始，创立；就职；获得学位
	inceptor	n.	学位获得者，接受学位的人
	inceptive	a.	开端的，起初的；[linguistics]始动词

incipient	a.	刚开始的，起初的 [FORMAL]
	incipiency	n.	开始 = beginning
	incipience = incipiency

inchoate	a.	刚开始的，不完全的（强调不完全 formless incoherent） [LITERARY] = incipient
	inchoation	n.
	inchoative	a.	=inchoate
		-ly		adv.

orthography	n.	（正确）拼写法
decease		v. n.	去世 [FORMAL]
fakery		n.	伪造，弄虚作假
visionary
oomph		n.	活力，热情
parachute	n.	降落伞
grudge
	grudging	a.	不情愿的

comply		vi.	顺从
	compliant	a.	顺从的，服从的[FORMAL]
		insubordinate	a.	不服从的
	compliance	n.	服从，顺从[FORMAL]

pliant		a.	易弯的；顺从的；
	pliantly	adv.
	pliancy		n.	
	pliable		a.	易弯的；顺从的；
		pliability	n.

complaisant	a.	顺从的，殷勤的[FORMAL]
	complaisance	n.	顺从，殷勤，彬彬有礼[FORMAL]

obey		v.
	obedient	a.	服从的，顺从的
	obedience	n.	服从，顺从

amenable	a.	顺从的
submit		v.	顺从，屈服
	submissive	a.	顺从的
	submission	n.
supple		a.	易弯的；顺从的；灵活的；

contumacious	a.	不服管束的，倔强的
insubordinate	a.	不顺从的，不听话的

prostitute	v.	卖淫
	prostitution		n.	卖淫

obsequious	a.	谄媚的，奉承的 [FORMAL]
	obsequiousness		n.

unction		n.	涂油，涂油礼；圣油；<-总之一群跟油有关的东西；谄媚，阿谀奉承(=unctuousness)；
	unctuous	a.	油腻的；谄媚的，阿谀奉承的；
		unctuosity	n.	油腻，油腻度
		unctuousness	n.	谄媚，阿谀奉承

flatter		v.	奉承，讨好
	flattering	a.
	flattery	n.
adulate		v.	奉承，拍马屁
	adulation	n.
	adulatory	a.
fawn		n.	幼鹿；鹿色；小孩；	v. （动物向人）表示好感；奉承，讨好；
saccharine	n.	糖精	a. 过于殷勤的，甜得发腻的
smarmy		a.	迎合的，过于殷勤的
toady		n.	马屁精，谄媚的人(=sycophant)	vi. 奉承，拍马屁
	toadyism	n.

stria		n.	条纹	(plural. striae) = striation
	striate		v.	加条纹	a. =striated 有条纹的
		striation	n.	= stria

strip		n. 条，带；脱衣舞；	vt. 除去，剥掉；脱衣服；拆卸（机器）；
stripe		n.	条纹，斑纹	vt. 画上条纹
	striped		a.	有条纹的 = variegate

debauch		vt.	使堕落，使放荡
	-ed		a.	堕落的，沉溺酒色的
	debauchery	n.	放荡，堕落，沉溺酒色，花天酒地
	debauchee	n.	放荡之人

vary		v.	变化
	variety		n.	多种多样
	various		a.	多种多样的
	variegate	v.	使...多样，画上杂色
		variegated	a.	色彩斑驳的，有斑点的
		variegation	n.

liable		a.	[法]有责任的(=responsible)；很可能发生的（be liable to sth/to do sth)
	liability	n.	责任，义务；可能，可能性；
		liabilities	n.	（特指）债务 = debts

lenity		n.	仁慈 = clemency
	lenient		a.	仁慈的，宽大的
		leniently	adv.
		leniency	n.	仁慈
		lenience = leniency

provide		v.
	provident	a.	有远见的，未雨绸缪的[FORMAL]
		providence	n.	天意，天命；远见(noun for provident)；
		providential	a.	（神谕般、天意般）幸运的
	provision	n.	（粮食、物资的）供给；条款；准备，预防措施；
		provisional	a.	临时的，暂时的
		proviso		n.	条件，条款（的附文）
			provisory	a.	附文的，有附带条件的(=conditional)；暂时的(=provisional)


utter		vt.	说，发声	a. 完全，彻底
	utterly		adv.	完全地，彻底地(=soundly)

solicit		v.	请求，征求[FORMAL]；
	solicitous	a.	关心的，关切的[FORMAL]
		solicitude	n.	关心，关切
	solicitation	n.	请求，征求[FORMAL]
	solicitor	n.	UK. AU. 初级律师
		barrister	n.	UK. AU. 大律师
		attorney	n.	US. 律师
		lawyer		n.	律师

feudal		n.	欧洲封建制度的
	feudalism	n.	欧洲封建制度

foreordain	v.	注定
damnation	n.	[宗教]下地狱，遭天谴
vie		vi.	竞争，争夺	(~ for/with/to_do)	vie vied vied vying

machine		n.	机器
	machinery	n.	（总称）机器；机构；	bureaucratic/political/decision-making machinery	官僚／政治／决策机构 the machinery of government 政府机构
	machinelike	a.	机器般的
	machinist	n.	机械师
	machinate	v.	密谋，策划阴谋
		machination	n.	阴谋，诡计

mechanic	n.	技师，修理工
	mechanics	n.	力学，机械学；机制，原理；
	mechanical	a.	机械的；机械般的；	mechanical engineering
		mechanically	adv.
	mechanize	vt.	使机械化
		mechanization	n.
	mechanism	n.	机械装置；机制；体制（制度）；	The mechanism for collecting taxes needs revising. 收税制度需要修改。
	mechanistic	a.	[哲学]机械论的
		mechanist	n.

discourse	n.	对话；演讲；文章；[FORMAL]

cathode		n.	阴极
anode		n.	阳极
cation		n.	阳离子
anion		n.	阴离子

plaudit		n.	赞扬

instrument	n.	乐器；器械；
	instrumental	n.	器乐的；*起作用的，有帮助的；*

ulcer		n.	溃疡
	ulcerate	v.	形成溃疡
		ulceration	n.
	ulcerative	a.

high heels = high-heeled shoes	高跟鞋

masculinity	n.	男子气概

sound		a.	完好无损的(intact)；合理的，明智的；完全的，彻底的；
	soundly		adv.	完全地(=utterly, completely)；
	resound		vi.	回响
	unsound		a.	（人的活动或判断）不够好的，靠不住的；（建筑）不稳固的；

needlessly	adv.	=unnecessarily

rite		n.	（宗教）仪式
nomenclature	n.	（尤指某一科学领域的）命名法
lineage		n.	血统[FORMAL]		refer to: extraction, descent
ardent		a.	热情的，（对某一行动）狂热的；火热的(an ardent sun)；发光的，闪亮的(ardent eyes)(=shining, glowing)；
parch		vt.	烤干，烤焦
fiery		a.	燃烧的；火红的；辛辣的；充满强烈感情的，激烈的，（尤指）愤怒的
	fierce		a.	激烈的，猛烈的

stamp		v.	（重）踩，踏
tramp		v.	（重）踩，踏	US also tromp
tread		v.	踩，踏
trample		v.	践踏；侵犯；
spurn		v.	（重）践踏(=trample)；轻蔑地拒绝；
# spur-表示踢，spur马刺在靴子上

confess		v.	坦白，招认（错误或罪行）；（基督教中向上帝或神父）忏悔；
	confession	n.	坦白；忏悔；

altar		n.	圣坛，祭坛

menial		a.	（工作）低贱的，不体面的
carapace	n.	（动物的）壳，甲壳

vivace
	vivacious	a.	活泼迷人的
	vivacity	n.

piety		n.	（对宗教的）虔诚	[FORMAL]
	pious		a.	（对宗教）虔诚的；[DISAPPROVING]假装真诚的，假惺惺的，虚伪的；
		pious hope/wish	n.	不太可能实现的愿望，不切实际的希望	something that is hoped for but will probably not happen
	impiety		n.	（尤指对上帝和宗教的）不敬，不恭
		impious		a.	（尤指对上帝或宗教）不敬的；不恭的

lackadaisical	a.	懒散的，慵懒的

vestibule	n.	门厅
porch		n.	门厅

yolk		n.	蛋黄
poach		v.	炖（直接和水接触）；偷猎；窃用；
coddle		vt.	在略低于沸点的水中炖；溺爱，纵容(indulge)；
simmer		v.	在略低于沸点的水中炖；酝酿，积聚；

pamper		vt.	溺爱，娇惯，纵容

slaver		vi.	流口水；渴望，垂涎[贬，强调令他人不悦的渴望](~ over)；	Stop slavering over that guitar, Stephen! 不要再垂涎那把吉他了，斯蒂芬！
saliva		n.	唾液

corona		n.	日冕，光晕	plural: coronae
	coronal		a.	头冠的，冠状的
	coronary	a.	冠状的
	coronation	n.	加冕礼
	coronet		n.	小王冠，a small crown
	coronagraph	n.	日冕观测仪
	coronograph = coronagraph
	# coroner		n.	验尸官


egregious	a.	（错误等）令人震惊的，极其严重的	It was an egregious error for a statesman to show such ignorance.  一位政界人士表现得如此无知，犯这种错误是极不应该的。
sagacious	a.	聪慧的，能洞察事理的(=wise)[FORMAL]

laud		vt.	赞美	[FORMAL]
	laudatory	a.	赞美的 [FORMAL]
	laudable	a.	[FORMAL]
	laudation	n.

deranged	a.	精神错乱的，发狂的

fatuity		n.	愚蠢
	infatuate	vt.	（excessive love / admiration）冲昏头脑，使狂热痴迷
		infatuation	n.	迷恋，痴迷
	fatuous		a.	愚蠢的

oblivion	n.	被遗忘，被忘却，无人知晓	He was another minor poet who was consigned to oblivion.  他也许又是一位怀才不遇、湮没无闻的小诗人。
	oblivious	a.	毫无察觉的

consign		vt.	运送，交付 [FORMAL]	The goods have been consigned to you by air.  货物已经空运给你了。
	consign sb/sth to sth


trivia		n.	琐事
	trivial		a.	琐碎的，微不足道的；容易解决的；平凡
		non-trivial	a.	[数]非平凡的；并非小打小闹的，有一定分量的；
		trivialize	vt.	贬低，使显得不重要
		triviality	n.	琐事；琐碎，无足轻重；

trifle		n.	琐事	v. 轻视（责任、决定等），不认真对待
	a trifle = a little = slightly = kind of = sort of 有点，稍微 I'm a trifle confused. 我有点迷惑。
	trifling	a.	微不足道的，不重要的

shirk		v.	逃避（工作、责任等）
swindle		vt. n.	诈骗，骗取（钱财）
	swindler	n.	骗子

serendipity	n.	机缘，幸运(the fact of finding interesting or valuable things by chance)

sentry		n.	哨兵；岗哨；
sentinel	n.	哨兵；岗哨； [LITERARY]		卫报 The Fort Lauderdale Sun-Sentinel Lauderdale堡太阳卫报

appease		v.	[贬]绥靖，为了息事宁人或讨好而妥协
customary	a.	惯常的(usual)；传统的(traditional)；
wont		n.	习惯，惯常	a. 习惯的，惯常的
	wonted		a.	通常的(=usual)	[FORMAL]
		unwonted	a.	不平常的(=unusual)，异常的

wean		vt.	使断奶
	unweaned	a.	尚未断奶的

torrent		n.	激流；集中的倾泻(barrage)；
	torrential	a.	猛烈的，激流般的

tolerant	a.	容忍的，忍耐的
	tolerate	vt.
	tolerable	a.
		tolerably	adv.
	tolerance	n.

vest		n.	背心；		v. 给予，授予
	divest		v.	脱去；剥夺(deprive, dispossess)；夺走；
		divestment	n.
		divestiture	n.	剥夺
	invest		v.	投资；授予(=vest)；
		investment	n.
		disinvest	v.	撤资
		reinvest	v.	用投资获得的利润再次投资
	vesture

revelation	n.	揭露，暴露(disclosure)	reveal -> revelation

courtesy	n.	礼节，礼貌
courteous	a.	有礼貌的，谦恭有礼的
postpone	vt.	推迟

shabby		a.	破烂的，破旧的；不公正的；
ill-bred	a.	没教养的，粗鲁的	ANTONYM: well-bred
surly		a.	粗鲁的，不礼貌的
	surlily		adv.
	surliness	n.

favor
	favorable
	favorite
		favortism
	disfavor
	in favor of

swelter		vi.	（人）感觉热急了，汗流浃背
reckless	a.	鲁莽的

agreeable	a.	令人愉悦的[FORMAL]；（东西）可接受的(sth is ~ to sb)；（人）愿意接受的(sb is ~ to sth)；
	agreeably	adv.	令人愉快地	We were agreeably surprised by the price.  这个价格真是让我们惊喜不已。

mystery
	mystic		n.	神秘主义者	a. =mystical
		mysticism	n.	神秘主义
	mystical	a.	神秘学的；
	mysticete
	mystique	
	mystagogue
	mysterious	a.	神秘的
	mystify		vt.	使迷惑
		demystify	vt.	解惑，使清晰易懂
		mystification	n.

communion	n.	（思想感情的）交流，沟通	[FORMAL]
antecede	vt.	在...之前(=precede)	Latin: antecedere
nimble		a.
	nembleness	n.

sanguine
phlegm		n.	痰；冷静，沉着[FORMAL]；	[希波克拉底气质论]粘液质->沉着冷静
	phlegmatic	a.	冷静的，沉着的[FORMAL]；冷漠的，冷淡的；
		phlegmatically	adv.
choleric
melancholic

tractable	a.	（情况）易处理的；（人）易管教的，易说服的	[FORMAL]
	intractable	a.	棘手的；难管教的；	[FORMAL]


nice		a.	细微的，微妙的	[FORMAL] based on very slight differences
	nicety		n.	细微的区别；微妙；

fragrance	n.	芳香；香水；
artful		a.	精明的，巧妙的	clever and skillful

mendacious	a.
	mendacity	n.
attest		v.	表明，证明

bent		n.	天赋

hedonism	n.	享乐主义
	hedonistic	a.	享乐主义的
	hedonist	n.

meretricious	a.	华而不实的，金玉其外败絮其中的 seeming attractive but really false or of little value

the Flood = the Deluge	圣经旧约中提到的滔天洪水
the ark			圣经中的方舟	Noah Ark
diluvium	n.	[archaic][geology]洪积层：一种已被证伪的地质层假说，认为一场大洪水造成了该地层，尤指圣经旧约中的大洪水	plural: diluviums or diluvia	Etymology: latin "diluere" -> dilute v.稀释 a.稀释过的
	diluvion = diluvium	plural: -s
	diluvial	a.	洪水的，洪水带来的
	diluvian = diluvial
		antediluvian	a.	[humorous]在大洪水之前的，戏谑极古老之物

reign		v. n.	统治
regime		n.	政权[MAINLY DISAPPROVING]；养生法；
regimen		n.	养生法；统治；政权(=regime)；

poise		n.	自信沉着，泰然自若	clam confidence, a quailty of grace
	poised		a.

senile		a.	老糊涂的，老态龙钟的	showing poor mental ability because of old age
	senilely	adv.
	senility	n.
dotage		n.	老糊涂的(=senility)
	dotard		n.	a person in its dotage

rectify		v.	纠正，矫正；整流（把交流电变成直流电）
	rectification	n.
	rectifier	n.	整流器
	rectitude	n.	诚实，正直

redoubt		n.	（尤指即将消失或受到威胁的信仰或生活方式的）藏身处，庇护所，堡垒，据点	the last redoubt of hippy culture	嬉皮士文化的最后堡垒	n. [SPECIALIZED][military] 防御工事，掩体
	redoubted	a.	[archaic] =redoubtable
	redoubtable	a.	强大可怕的；杰出的，值得尊敬的；

eminent		a.	凸出的(=projecting, protruding, prominent)；杰出的，卓越的；	from Latin eminent-, eminens, present participle of eminēre: to stand out
	eminently	adv.
	eminence	n.
	supereminent	a.	=preeminent，只形容人
	prominent	a.	凸出的(=projecting, protruding, eminent)；显眼的，显著的；杰出的，著名的；
		prominence	n.
			solar prominence	n.	日珥（太阳表面的火舌状焰柱）
	preeminent	a.	杰出的，卓越的，强调凸出于众人的能力、才华或地位
		preeminence	n.

noteworthy	a.	值得注意的

fume
	fumigate
	fumigant
	perfume
		perfumery

constrain	vt.	限制
	constrained	a.	受限制的；拘谨的，局促的，不自然的；	a constrained voice/manner
	feel constained to do	认为自己必须做

oblige		v.	帮助，为..效劳；（以法律或道义）强迫，强制(US./UK-FORMAL =obligate)；
	obliging	a.	乐于助人的
	disoblige	vt.	违背...的愿望；给...带来不便(=inconvenience)；
	obligate	vt.	（以法律或道义）强迫，强制
		obligatory	a.	强制的，义务的
		obligation	n.

inconvenience	n	不便，麻烦	*vt. 给...带来不便，麻烦*

contend		vi.	竞争，争夺	vt.+that	声称，断言，主张
	contentious	a.	（事件）有争议的；（人）好争论的；
		contentiously	adv.
		contentiousness	n.
	contention  	n.  	争论；看法

stint		v.	限量提供
	unstinting	a.	极慷慨的，极大方的

condition	vt.	调整，使处于理想状态
	recondition	vt.	修理（再调整）

thoughtless
unthinking
incogitant

invoice		n.	发票	vt. 给...开发票
patio		n.	露台	plural: patios
quote		n.	引用；*报价*；
clutter		n.	杂乱，乱七八糟		vt. 塞满，乱堆在
reckon		vi.	想，认为
	reckoning	n.	计算(=calculation)
well-versed	a.	精通的，熟知的(be well-versed in sth)

thievish	a.	of, or relating to, or characteristic of a thief; given to stealing

benifit

persevere	v.
	persevering	a.
	perseverance	n.

presume		vt.
	presumable	a.
		presumably	adv.
	presumption	n.
	presumptive	a.
	presumptuous	a.	

mellow		a.	柔和的；（声音）柔和的，圆润的；轻松的，令人愉快的；	vi. 变柔和	vt. （使）放松

melliferous	a.	产蜜的
mellifluous	a.	（声音）甜美流畅的	Middle English mellyfluous, from Late Latin mellifluus, from Latin mell-, mel honey + fluere to flow
	mellifluously	adv.
	mellifluousness	n.
mellifluent = mellifluous
	mellifluently	adv.
	mellifluence	n.
mead		n.	蜂蜜酒（用蜂蜜酿的）

the Labyrinth	n.	希腊神话中的迷宫，由Asterion(Asterius)把守	Greek: λαβύρινθος labyrinthos
	labyrinth	n.	迷宫
		labyrinthine	adj.	迷宫般的

spotlight	n.	聚光灯	vt. 用聚光灯照亮；曝光，使公众关注；
wretch		n.	可怜的人，不幸的人；坏人，流氓[INFORMAL or HUMOROUS]
	wretched	a.	不幸的；质量差的；

scorch		vt.	烤焦；烘干(=parch)；谴责，挖苦；破坏(see ~ed earth)；	vi. 烧焦；飞驰，狂奔；
	scorched earth	焦土政策（当敌人进入或撤出某处时破坏任何可能对敌人有用的东西）
	scorching hot	极热
singe		vt.	烧焦，烤焦(to burn superficially or lightly, =scorch (m-w))
parch		vt.	烤干（roast slightly)
roast		v.	烤，烘焙（食物）	roast sb [INFORMAL]喷（严厉批评）
toast		vt.	烤（食物）；为...干杯；		n. 干杯；吐司面包；

afflict		vt.	折磨，使痛苦

shrivel		v.	（使）枯萎，（使）干枯；	vi. （经济等）缩小，萎缩
lettuce		n.	生菜（叶用莴苣的俗称）

shin		vi.	爬(~ up)	n. 胫(the front part of your leg between your knee and your foot)
eatery		n.	=a restaurant	[INFORMAL] 餐馆

critical list	n.	病危名单
	be on/off the critical list	在病危名单上/从病危名单上去除；[FIGURATIVE] 处于危险之中/脱离危险

serve		v.
	serving		a.	现役的	serving and retired military officers 现役和退役的军官
	server		n.	
	servitor = servant
	servant		n.
		public servant/servant of the state
		a person who works for the government 公务员，公仆
			Public servants should be incorruptible.  公务员应该做到清正廉洁。
	service		n.
		serviceable	a.	合适使用的	suitable for use
		serviceberry	n.	花楸(树)果(实)
		serviceman	n.	男兵，男军人
		servicewoman	n.	女兵，女军人
		serviceperson	n.	军人；（设备）维护人员；
	serviette	n.	餐巾，餐巾纸(UK)(=napkin)
	servo = servomechanism
	servomechanism	n.	伺服机构（或系统）(a system that uses a small amount of power to control the power of a larger machine)
	servomotor	n.	伺服电动机(a motor that provides the power for a servomechanism)
	servient	a.	现役的(=serving)；从属的，下属的(=servile)；受奴役的；
		subservient	a.	恭顺的，卑躬屈膝的
		servitude	n.	奴役（比slavery好一点？）
	servile		a.	卑躬屈膝的，过度谦卑的

sonant
	resonant	a.	（声音）洪亮共鸣的；（观点、情感）引起共鸣的；
		resonate	vi.	发出共鸣，回响；（思想、感情）产生共鸣；
		resonance	n.
	dissonant	n.	不和谐的，刺耳的
		dissonance	n.	不和谐，不一致，（意见的）分歧
	consonant	n.	辅音字母（元音: vowel）；一致的，符合的，和谐的；
		consonance	n.	和谐，一致(=harmony)
		consonantal	a.	辅音的
		inconsonant	a.	不和谐的，不一致的
			inconsonance	n.	不和谐，不一致

syllable	n.	音节	a single unit of speech, either a whole word or one of the parts into which a word can be separated, usually containing a vowel
	syllabic	a.	音节的

vestige		n.	遗迹 [FORMAL]；退化的器官；
	vestigial	a.	残留的，残余的；（器官）退化的，发育不全的；	Vestigial remains of these plays are now seen in the Christmas pantomime.	这些剧目的残余部分现在能在圣诞哑剧中被发现。

prevail		vi.	胜出，占上风，占优势；流行，盛行；
	prevailing	a.	盛行的，普遍的
	prevalent	a.	盛行的，普遍的

fortuante	a.
	unfortunate	a.	不幸的；[FORMAL] （言论或行为）令人尴尬的，不恰当的，得罪人的

felicitous	a.	令人愉快的(~ weather, =pleasant,delightful)；恰当的，贴切的；
	infelicitous	a.	不恰当的，不合适的，令人尴尬的；*根本没有“不幸”的意思*

triumphant	a.	凯旋的；[Derivative] 洋洋得意的；

entreat		vt.	恳求	to try very hard to persuade someone to do something
	entreaty	n.

portent		n.	预兆
	portentous	a.	预兆的[LITERARY]；*自命不凡的，自大的 [FORMAL & DISAPPROVING]*；

glabrous	a.	光洁的，无毛的
precocious	a.	（尤指儿童）智力超常的，早熟的；少年老成的[DISAPPROVING]；

resile		v.	改变先前的决定或想法
	resilient	a.	有弹性的，能复原的
		resilience	n.	弹性，复原力
		resiliency = resilience

recluse		n.	隐居者；喜欢独处的人	a. 隐居的(=solitary, secluded)
	reclusive	a.	隐居的，喜欢独处的
		-ly		adv.
	reclusion	n.

seclude		vt.	使隐居	[REFLEXIVE] He preferred to seclude himself in the laboratory.
	secluded	a.
		secludedness	n.
	seclusive
		seclusively	adv.
		seclusiveness	n.
	seclusion	n.
		seclusionist	n.	隐居者

singularly	adv.	特别地	singularly beautiful	特别漂亮

dial		n.	仪表盘
startle		vt.	使吃惊，使受惊
	startling	a.	惊人的

murk		n.	黑暗，昏暗
	murky		a.	黑暗的，昏暗的；（形势）复杂难懂的，不明朗的；

gloom		n.	忧郁，愁闷；昏暗，幽暗[LITERARY]；
	gloomy		a.	忧郁的，悲观的；灰暗的；

endemic
pandemic

epidemic

Saturn		n.	土星
	saturnine	adj.	阴郁的，严肃的

contact lens	n.	隐形眼镜
frantic		a.	发狂的，情绪失控的
	frantically	adv.

obviate
ostracize
oscillate = vacillate

opprobrium	n.	谴责，抨击
	opprobrious	a.

sepulchre	n.	石墓	a stone structure where someone is buried
	sepulchral	adj.	阴沉的，阴森森的

sedent		a.	坐着的(=sitting)，多用于形容雕像	Latin sedent-, sedens, present participle of sedēre to sit
	sedentary	a.
		1 :not migratory :settled sedentary birds, sedentary civilizations 非迁徙的鸟类，定居（非迁徙，非游牧）的文明
		2 
			a :doing or requiring much sitting: a sedentary job	久坐的
			b :not physically active: a sedentary lifestyle		定居的，不活动的
		3 :permanently attached: sedentary barnacles(barnacles:（岩石、船底等处的）附着甲壳动物，藤壶)

ire		n.	（公开明显的）愤怒，怒火(intense and usually openly displayed anger)	[FORMAL]	vt. 激怒
	ireful		a.
	irate		a.	愤怒的 1. roused to ire 2. arising from anger
		irately		adv.
		irateness	n.

distinct	a.	明显的，确实的；明显不同的；	There's a distinct smell of cigarettes in here.  这里确实有一股烟味儿。
	indistinct	a.	不清楚的，模糊的	an indistinct shape/sound/recollection 模糊的形状／声音／记忆

devalue		v.	（使）贬值	vt. 贬低，轻视
	devaluation	n.

probable	a.	很可能发生的，强调发生的概率较大
	improbable	a.	不太可能发生的
	probably	adv.
	probability	n.

plaudit		n.	赞扬(=praise)	[FORMAL]

tend		vi.	倾向(~ to)	vt./vi.+to 照顾，照料[FORMAL]	Nurses tended to the injured.  护士们照料伤员。
	tender		a.	温柔的，关切的；年幼的[LITERARY]；	vt. 提交[FORMAL]	vi. 投标(If you tender for a job, you make a formal offer to do it for a stated price.)
	tendency	n.	（思想、行为等的）倾向(see disposition)；倾向，趋势；
		tendentious	a.	（发言）有倾向（性）的，有偏见的

particular	a.	特定的，特别的(this and NOT any other)；讲究的，挑剔的；	He's very particular about the kitchen - everything has to be perfectly clean and in its place.  他对厨房非常挑剔——每样东西都得一尘不染，该放哪放哪。

fuss		n.	大惊小怪，（因小事）过度激动	vi. 过度关注（细节），为小事烦恼
	fuss over sb/sth	过分宠爱/过度关注
	fuss with sth		（因为紧张或犹豫）摆弄	She's always fussing with her hair.
	fussy		a.	过分挑剔的；过度花哨的；	a fussy wallpaper pattern

overly		adv.	过分地，过度的(=excessively)

upset		vt.	to make someone worried, unhappy, or *angry*	使心烦意乱，强调使内心失去平静，而具体的形式不限于沮丧，也可以是担忧或*愤怒*

probity		n.	诚实，正直
	improbity	n.

pursue		v.
	pursuit		n.	嗜好，消遣（追求）；追踪；追求；

forth		adv.	（时间、地点上）向前	*from that day forth* / They set forth on their travels in early June.		adv. out into notice or view (m-w); When someone or something is brought forth, they are brought to a place or moved into a position where people can see them. out, esp,: out into view, as from hiding (collins)		adv. [OBSOLETE] away, abroad
	forthright	a.	直率的，直截了当的	adv. =forthrightly
		forthrightly	adv.
		forthrightness	n.

whither		adv.	=where
boutiful	a.	数量巨大的；慷慨的；	[LITERARY]

unfold		vt.	展开；（形势或故事）发展；详细讲述（尤指计划） Gradually, the author unfolds a fantastical tale.	Unfold your plan to us! 给我们说说你的计划！	[FORMAL]；

outspoken	adj.	直率的，直言不讳的

composure	n.	沉着，镇定，泰然自若	the feeling of being calm, confident, and in control

zest
	zesty

sanc		Latin: sanctus = sacred
	saint		n.	圣人
	sage		n.	圣人	a. 贤明的
	sanctuary	n.	庇护所；圣殿，圣堂(the most sacred part of a religious building)
	sanctum		n.	圣所	plural: sancta
	sanction	vt.n.	批准，认可；（贸易）制裁；	to make holy
	sanctimony	n.	假神圣，假虔诚(affected or hypocritical holiness)
		sanctimonious	a.	假装圣洁的，道貌岸然的，伪善的
	sanctify	vt.	使神圣
	sanctity	n.	神圣性 the sanctity of a cemetery/tomb 墓地的神圣性

frown		vi.	皱眉	frown on/upon sth 不赞同，表示异议

trying		a.	（任务）棘手的，难对付的

sate		v.
	satiate		v.
	satiety		n.
	satiable	a.
		insatiable	a.

perspicuous	a.	(speech or writing)清晰明了的，易懂的
	perspicuity	n.

perspicacious	a.	(of people)有洞察力的，聪明的
	perspicacity	n.

perspire	vt.	流汗	polite word for `sweat`	[FORMAL]
	perspiration	n.
	anti-perspir-ant	n.	（尤指涂在腋下等皮肤表面的）止汗剂

punchline	n.	（故事或笑话的最后部分点题或抛出笑料等的）妙语，画龙点睛的结尾句：笑点

lament		vi. 大声哀哭(to mourn aloud, =wail)	vt. 对...感到悲痛惋惜	vt. 极度后悔	n. 挽歌，悼诗(=elegy, dirge)[FORMAL]
	lamentable	a.	值得惋惜的(=deplorable)；悲痛的(expressing grief, =mournful)；

mourn		v.	（对人的去世，物的消亡、丢失而）（感到/表达）哀伤，悲伤
	mournful	a.	哀伤的，悲伤的

outpost		n.	前哨，前哨基地

attachment	n.	附件；喜爱，爱慕，依恋；
detachment	n.	小分队，行动小组；	n. 淡漠，冷漠，事不关己；

jest		n.	笑话 [FORMAL]	vi. 开玩笑(~ about)
	in jest

kin		n.	[archaic]家属，亲属
	next of kin	[FORMAL]
		your closest relation or relations 直系亲属；最近的亲属
			We can't release his name until we have informed his next of kin.  在通知他的直系亲属前，我们不能透露他的名字。
	akin	a.	血族的，同族的；相似的；

quiet		a. v.
	unquiet		a.	不平静的；焦躁不安的	[LITERARY]
		unquietude	n.	wtf
	disquiet	n.	焦虑，担心，不安(=worry)
		disquietude	n.
	inquite = disquiet	[archaic]
		inquitetude	n.
	quietude	n.	平静；宁静；安宁[FORMAL]	In many of his poems the poet reflects on the quietude of the countryside.  在他的许多诗中，诗人描写了乡村的宁静。
	quieten		v.	UK （使）安静 = US quiet v.
	quietism	n.	淡泊，清静无为；17世纪西班牙的寂静主义，主张无为；
	quietus		n.	偿清（债务）；寂灭（偿清生命）；抑制物；
		discharge a debt	清偿债务	[FORMAL]
	requiem		n.	镇魂曲
	requiescat	n.	安魂的悼词
	quiescent	a.	静止的，平静的	Latin quiescent-, quiescens, present participle of quiescere to become quiet, rest, from quies
		quiescently	adv.
		quiescence or quiescency	n.
		acquiesce	vi.	默许，勉强同意
			acquiscent	a.	默从的		willing to do what other people want
				acquiescence	n.	默许
	
gall		n.	胆；鲁莽，厚颜无耻；激怒；
	gallstone	n.	胆结石
	gallbladder	n.	胆囊
		bladder		n.	膀胱；囊状物；
		bile		n.	胆汁；愤怒，怒气；
			biliary		adj.

chol- chole- cholo-	=bile, gall 胆汁的，胆的	Greek chol-, cholē-, cholo-, from cholē, cholos
	choleric	n.	胆汁气质的；易怒的；
	cholesterol	n.	胆固醇
	cholera		n.	霍乱

calc- calx	Latin: lime 石灰
	calcium		n.	钙
	calcify		v.
	calculus	n.	微积分；结石；		Latin: calculus = stone, pebble (used in reckoning)
	calculate	v.	Latin calculatus, past participle of calculare, from calculus pebble (used in reckoning), perhaps irregular diminutive of calc-, calx lime
		calculating	a.	工于心计的；精明的；狡猾的
		calculation	n.	
	chalk		n.	粉笔

inflection	n.	词形变化，屈折变化，如determines, determining, and determined由determine而来，本身的意思不变。区分于Morphological derivation，后者指派生，如quite->disquite->disquitude，单词的意思也改变。
	decline		v.	名词、代词、形容词变格（数量、主宾格、性别）		girl girls girl's girls' 	China Chinese
		declension	n.	（一组同根变化的名词、代词、形容词）；这种变化法本身；
	conjugal	a.	婚姻的
		conjugate	v.	（使）结合；	adj. 结合的；[数]共轭的；	v. 动词变格	break, breaks, breaking, broke, broken
			conjugation	n.	结合；一组动词的变格；这种变化法本身；
# And here's a little on-topic joke I came across recently:
# A verb walks up to a noun in a bar:
# -- Hey, babe, wanna go back to my place and conjugate?
# -- I decline.

oblique		n.	主格和呼格以外的所有人称
vocative	n.	呼格

grace
	graceful	a.	优雅的，得体的
	gracious	a.	高贵优雅的
	disgrace	n.	

garage		n.	车库

fringe		n.	（地区或群体的）边缘，外围
	infringe	v.	侵犯，违反（规定、法律等）	[超出（法律）边缘 -> 违反，侵犯]
		infringement	n.	违反

alternative	a.	另类的，非传统的	alternative band

macula		n.	（皮肤上的）斑点；（矿石上的）斑点；（太阳表面的）黑点；
	macular		a.
	maculate	a.	有斑点的；（名誉）有污点的；	v. 玷污[archaic in AmE]
		maculated	a.
		immaculate	a.	整洁的；完美的；
		maculation	n.	斑点

smart		a.	整洁的；时髦优雅的(stylish or elegant in dress or appearance)；
stylish		n.	时髦的，格调优雅的	having style; specifically :conforming to current fashion

hiss		嘶嘶声；嘘声；
boo
whistle		口哨，吹口哨
capacity	n.	容量；职位，工作；
decry		vt.	谴责，抨击(=condemn)	[FORMAL]
	decrial		n.
	decrier		n.

juxtapose	v.	把（不同的事物）并置，把…并列
lurid		a.	

concede		v.	让步，不情愿地承认
	concession	n.	让步；认输（承认失败）；

exult		vi.	欢欣鼓舞，狂喜
	exultant	a.	极高兴的，狂喜的

ambulate	vi.	走动(=walk)
	ambulation	n.
	perambulate	vt.	（徒步）巡游；（徒步）巡视；	vi. 漫步(=stroll)
		perambulatory	a.
		perambulation	n.

dismissive	a.	轻视的，轻蔑的
pedant		n.	书呆子，过于关注不重要的细节和传统规则的人[DISAPPROVING]
	pedantic	a.	书呆子气的，过于拘泥细节的
embroil		vt.	使卷入（纷争）
malleable	a.	具延展性的，易变形的；易受外界影响的(=susceptible)；
lionize		vt.	使成名；将…视作名人
backlash	n.	（社会或政治方面的）强烈反响，强烈反对
bereft		a.	缺乏…的；感到失落的
	bereftness	n.
bereave		vi.	剥夺；夺走；  past tense/past participle: bereaved or bereft
	bereft		a.	
		bereftness	n.
	bereavement	n.	丧失亲人
avocation	n.	业余爱好
stale		n.	（通常指因久放）不新鲜的，走味的


detonate	v.	引爆，（使）爆炸

auspicious	a.	吉利的，吉祥的	suggesting a positive and successful future
advantageous	a.	=favorable	有利的

disaffected	a.	（对权威）不满的，叛逆的(=rebellious)
unaffected	a.	未受影响的；真诚的(=genuine)；

grudge		n.	怨恨		refer to: rancor
resent		vt.	怨恨，对...感到不满
	She bitterly resented her father's new wife.  她对她父亲新娶的妻子恨之入骨。
	[ + -ing verb ] He resents having to explain his work to other people.  他讨厌非得向人们解释他的工作。
	resentful	a.	愤恨的，反感的

synergic	a.	合作的，协作的

# Latin: salutare salut- salus = health
salute		n. v.	（尤指军人）敬礼	vt. 公开赞扬，赞颂[FORMAL]
	salutation	n.	问候，致意
		salutatory	a.	致意的，表示欢迎的
		salutatorian	n.	US 代表毕业生致词之学生，致辞者
	salutary	a.	有益的
	salubrious	a.	有益健康的

genuine		a.	真正的（非伪造的）；真诚的；
generous	a.	慷慨的；大量的(a generous slice of cake 一大块蛋糕)
ingenuous	a.	天真幼稚的
	disingenuous	a.	不真诚的，不坦诚的(lacking in candor)
ingenious	a.	（人）intelligent and skillful；（物）独创且精巧的；
ingénue		n.	=ingenue	a naive girl or young woman	（尤指电影或戏剧中）天真无邪的少女

homogeneous	a.
	homogenize	vt.
	homogenous = homogeneous
	# heterogeneous	a.

resourceful	a.	机敏的，足智多谋的
	resourcefulness	n.

palate		n.	腭(the top part of the inside of your mouth)；（对美食、美酒的）鉴赏力；
	palatable	a.	美味的，可口的[FORMAL]
		unpalatable	a.

gladiator	n.	（古罗马）角斗士
	gladiatorial	a.	你死我活的；狭路相逢的 		gladiatorial combat 你死我活的战斗

heirloom	n.	传家宝，祖传之物
inculcate	vt.	反复灌输，谆谆教诲	[FORMAL]

feud
	feudal
		feudalism

formality	n.	礼节；俗套；例行公事	something that has to be done but has no real importance	n. 庄重，正式

petty		a.	（事情）琐碎的，不重要的；（人）过分在意琐事细节的；

puissance	n.	权力(=strength, power)
	impuissance	n.	无权(powerlessness)；虚弱(weakness)；

avert		v.	转移，转开；阻止，防止；Latin:avertere, ab + vertere(to turn)
	averse		a.	反对的
		aversion	n.	厌恶，反感
odium		n.	憎恨，厌恶	[FORMAL]

subdue		vt.	压制，控制

ascend		v.	上升；攀登；
	ascent		n.	上升；攀登；成功，腾达；
	ascendant	a.	有影响力的，主宰的
descend		v.	下降；世代相传；
	descent		n.	血统，出身；下降；堕落；

stigma		n.	耻辱，污名	plural: stigmata or stigmas   古希腊烙在奴隶身上的烙印，复数stigmata指圣痕，即耶稣手脚上的钉伤痕迹，基督教主教称这些圣痕会重现在自己的身上
	stigmatic	a.
	stigmatize	vt.	打上烙印，蒙上污名
	astigmatic	a.	散光的；盲目的；	an astigmatic fanaticism, a disregard for the facts—The New York Herald Tribune	盲目的狂热，对事实的无视
		astigmatism	n.	散光；盲目，曲解；

suggestive	a.	引起联想的(be ~ of)；性暗示的，性挑逗的；
spin
	spindle		n.	（机器的）轴；纺锤，绕线杆
		spindly		a.	纺锤般的，细长瘦弱的，长而纤弱的

Latin: nasci = to be born
	nascent		a.	新生的
		nascence	n.
		renascent	a.	复活的，复兴的(=reviving)
	renaissance	n.	复兴	the Renaissance 文艺复兴
	nation

beget		vt.	[archaic]成为...的父亲(=sire)；引起，导致；
procreate	vi.	生育

vernal		a.	春天的	[FUCKING LITERARY]
	vernal equinox	n.	春分
longevity	n.	长寿
lugubrious	a.	忧伤的，悲伤的
flagrant	a.	骇人听闻的，公然的 shocking because of being so OBVIOUS
indolence	n.	懒惰	[FUCKING LITERARY]
conflate	vt.	合并，结合
all-round	a.	多才多艺的

# 虽然没有ept这个词，但是ept似乎是apt的各种derivation的等价物
apt
	aptly
	aptness		n.
	inapt		a.	1. 不合适的(not suitable)	2. =inept
		inaptly
		inaptness
	aptitude	n.	才能，资质；合适（性）（=aptness)
		aptitudinal
		aptitudinally
		inaptitude	n.
	inept		a.	无能的；不合适的；
		ineptly
		ineptitude	n.

vivace		a. adv.	（音乐）生动活泼的
	vivacious	a.	活泼迷人的
	vivacity	n.

sator		n.	[HUMOROUS or LITERARY and RARE] 裁缝	=tailor
	satorial	a.	衣着上的，制衣的	satorial elegance

tacit		a.	默契的		understood without being expressed directly
	taciturn	a.	沉默寡言的	tending not to speak much

swerve		vi.	突然转向；改变，背离；
	unswerving	a.	（信任或信仰）坚定的，不懈的，始终如一的

confidant	n.	知己，密友

mordant
	mordancy
		mordancious

encumber	vt.	拖累，阻碍
	encumberance	n.
